11111111111111111111
10000000000000000001
1000000000000000C111
100P0000000E000001
10000000000000C00111
10000000000000000001
11111111111111111111