11111111111111111111
100000000000000000E1
1000000000000000C001
100P0000000011111111
10000000000010C00001
10000000000010000001
11111111111111111111