11111111111111111111111111111111111
10000000000000000000000000000000001
100P0000000000000000000000000000001
10000000000000000000000000000000001
1000000000000000000C000000000000001
10000000000000000000000000000000001
10000000000000000000000000000000001
10000000000000000C00000000000000001
10000000000000000000000000000000001
10000000000000000000000000000000001
100000000000000C0000000000000000001
10000000000000000000000000000000001
11111111000000000000000000000000001
1000000000000C000000000000000000001
10000000000000000000000000000000001
10000000C10000000000000000011111101
100000000100000000000000000100E0001
10000000010000000000000000010000001
10000000010000000000000000010000001
11111111111111111111111111111111111