1111111
1P000P1
100C001
1E00001
1111111