11111111111111111111
10000P00000000000001
1000000000000000C001
100E0000000000000001
10000000E00000C00001
10000000000000000001
11111111111111111111