11111111111111111111
10000000000000000001
10000000000000000001
100P00000000000E0001
10000000000000000001
10000000000000000001
11111111111111111111