11111111111111111111
10000000000000000001
10000000000E0000C001
100P0000000000000001
10000000000000C00000
10000000000000000001
11111111111111111111