111111111111
1000100000E1
110000000111
1000000001C1
111100100001
1P0001100001
111111111111