111111111111111111111111111111
100000000000000000000000000001
100P00000000000000000000000001
100000000000000000000000000001
1000000000000000000C0000000001
100000000000000000000000000001
10000000000000000C000000000001
100000000000000000000000000001
100000000000000C00000000000001
111111110000000000000000000001
1000000000000C0000000000000001
10000000C100000000000011111101
1000000001000000000000100E0001
100000000100000000000010000001
100000000100000000000010000001
111111111111111111111111111111