11111111111111111111
100000000010000000E1
10000000C01000000001
100P0000001000000001
1000000C001000000001
10000000001000000001
11111111111111111111