11111111111111111111
100000P0000000000001
1000000000000000C001
100E0000000000000001
10000000000000C00001
10000000000000 00001
11111111111111111111